##############___________########################################
#------------#___________#--------------------------------------#
#------------#___________#--------------------------------------#
#------------#___________#--------------------------------------#
#------------#___________#-----------------T--------------------#
#------------#___________#--------------------------------------#
#--------F---#___________#--------------------------------------#
#------------#___________#--------------------------------------#
#-------######___________############-----------R---------------#
#-------#___________________________#---------------------------#
#-------#___________________________#---------------------------#
#-------#############################-----O---------------------#
#---P-----------------------------------------------------------#
#---P---------------------------------------------T-------------#
#---D------------A----------------------------------------------#
#------------S--------------------------------------------------#
#---S-----------------H-------------------G---------------------#
#---------------------------------------------------------------#
#------------D--------------------------------------------------#
#---------------------------------------------------------------#
#-------------------------------------------------T-------------#
#################################################################