##############___________########################################
#------------#___________#--------------------------------------#
#------------#___________#--------------------------------------#
#------------#___________#--------------------------------------#
#------------#___________#--------------------------------------#
#------------#___________#--------------------------------------#
#------------#___________#--------------------------------------#
#------------#___________#--------------------------------------#
#-------######___________############---------------------------#
#-------#___________________________#---------------------------#
#-------#___________________________#---------------------------#
#-------#############################---------------------------#
#---------------------------------------------------------------#
#---------------------------------------------------------------#
#---------------------------------------------------------------#
#---------------------------------------------------------------#
#---------------------------------------------------------------#
#---------------------------------------------------------------#
#---------------------------------------------------------------#
#---------------------------------------------------------------#
#---------------------------------------------------------------#
#################################################################