##############___________########################################
#------------#___________#--------------------------------------#
#------------#___________#--------------------------------------#
#------------#___________#--------------------------------------#
#------------#___________#--------------------------------------#
#------------#___________#--------------------------------------#
#--------F---#___________#--------------------------------------#
#------------#___________#--------------------------------------#
#-------######___________############---------------------------#
#-------#___________________________#---------------------------#
#-------#___________________________#---------------------------#
#-------#############################---------------------------#
#---P-----------------------------------------------------------#
#---------------------------------------------------------------#
#----------------A----------------------------------------------#
#------------S--------------------------------------------------#
#---------------------H-----------------------------------------#
#---------------------------------------------------------------#
#------------D--------------------------------------------------#
#---------------------------------------------------------------#
#---------------------------------------------------------------#
#################################################################