##############___________#############################EE#########
#------------#___________#-----O--------------------------------#
#------------#___________#--------------------------------------#
#------------#___________#------------------------------T-------#
#------------#___________#---T-------------T--------------------#
#------------#___________#--------------------------------------#
#--------F---#___________#--------------------------------------#
#------------#___________#--------------------------------------#
#-------######___________############-----------R---------------#
#-------#___________________________#---------------------------#
#-------#___________________________#---------------------------#
#-------#############################-----O---------------------#
#---P------------------------------------------------------R----#
#---P-----------------------------------------------------------#
#---D------------------------A----------------------------------#
#----------------------R----------------------------------------#
#---S-----------------------------------------------------------#
#---------------------------------------------B-----------------#
#---------------------------------------------------------------#
#--------------------------R--------------------------O---------#
#---------------------------------------------------------------#
#################################################################