##############___________########################################
#------------#___________#--------------------------------------#
#------------#___________#---------------------------T----------#
#------------#___________#---------T----------------------------#
#------------#___________#-----------------T----------O---------#
#------------#___________#------O-------------------------------#
#--------F---#___________#----------------------------------R---#
#------------#___________#--------------------------------------#
#-------######___________############-----------R---------------#
#-------#___________________________#---------------------------#
#-------#___________________________#---------------------------#
#-------#############################-----O---------------------#
#---P------R----------------------------------------------------#
#---P----------------------O-----------------------T------------#
#---D-----------------------------------------------------R-----#
#---------------------------------------------------------------#
#---S--------------------------------R--------------------------#
#--O--------R---------------------------------B-----------------#
#---------------------------------------------------------------#
#----------------------------------T----------------------------#
#---------------------------------------------------------------#
#################################################################