###EE#############################################
#-----YYYY--Y----YYYR--~~~~~~~~~~~YYY-------YYYYY#
#-----------------Y-----~~~~~~~~YY-----------YYYY#
#------D--------------~~~~~~~~~Y--F---YY-------YY#
#-YY-YYYYYYYY---G---~~~~~~~~~Y----------------YYY#
#YY-YYYYYYY-------~~~~~~----~-----T--------YYYYYY#
#------YYY-----Y~~~~~~##---O------------YYYYYYYYY#
#------G------~~~~~~--##-------------------------#
#--~-~---T--~~~Y~~--------#######--###############
#~~~~~~~--~~~~~~~-----R---##---##--##------------#
#~~~~~~~DP~~~~~Y-----YY-Y---------------F--------#
########--##---------YYYYY-----------------------#
#-----##--##---------------##----##--------------#
#--F-----O-----Y#-#Y---T---##----##--------------#
#-----T--------#---####################---########
#########--####-----##-------------T-------------#
#------#--------------#--------------------------#
#-####-#-------------#-#--###########-----#------#
#----T-------###--###-----#---------------#------#
#------------##----##--------------S------#----R-#
#----##-----####--#####-------------#-#---#------#
#----###---####----##--#####--#########---########
#---T------------------------P-----------O-------#
#--------S-------R-----------A-------------------#
##--##-------##-#--####------F------#--------#---#
#----#-------###-####-##-------------------------#
#--O-#-------##-T--##--#####----T---#----B---#---#
#----#----O--###---------------------------------#
#----#-------##----------------------------------#
##########################################E#######