#########-----------------------------------------
#-------####-------###########--------------------
#-----------##-----#------R--#--------------------
#-------------##---#--O-----T#--------------------
#-------##------##-#T---R----#--------------------
#########-##---R--##-------O-#--------------------
------------##---O----O------#--------------------
--------------##-------------#--------------------
----------------####T---O--T-#--------------------
------------------##--R------#--------------------
-------------------###PP######--------------------
---------------------#--#-------------------------
---------------------#--#-------------------------
---------------------#AA#-------------------------
--------------------#--T-##-----------------------
------------------##-------##---------------------
-----------------#-----------#--------------------
-----------------#-----------#--------------------
----------------#---B------B--#-------------------
----------------#-------------#-------------------
---------------#T------------R-#------------------
---------------#-------T-------#------------------
---------------#---------R-----#------------------
----------------#-------------#-------------------
----------------#---B------B--#-------------------
-----------------#-----------#--------------------
-----------------#-----------#--------------------
------------------##-------##---------------------
--------------------##---##-----------------------
----------------------###-------------------------