###EE#############################################
#-----YYYY--Y----YYY---~~~~~~~~~~~YYY-------YYYYY#
#-----------------Y-----~~~~~~~~YY-----------YYYY#
#-------------O-------~~~~~~~~~Y------YY-------YY#
#-YY-YYYYYYYY---G---~~~~~~~~~Y-----O----------YYY#
#YY-YYYYYYY-------~~~~~~----~--------------YYYYYY#
#---D--YYY-----Y~~~~~~##----------------YYYYYYYYY#
#------G------~~~~~~--##-------------------------#
#--~-~------~~~Y~~--------#######--###############
#~~~~~~~--~~~~~~~---------##---##--##------------#
#~~~~~~~--~~~~~Y-----YY-Y------------------------#
########--##---------YYYYY---------------F---S---#
#-----##AF##---------------##----##--------------#
#--------------Y#-#Y-------##----##--------------#
#--------------#---####################---########
#########--####-----##---------------------------#
#------#---------T----#--------------------------#
#-####-#-------------#-#--###########-----#------#
#------------###--###-----#-----O---------#------#
#------------##----##---------------------#------#
#----##-----####--#####-------------#-#---#------#
#----###---####----##--#####--#########---########
#----------------------------------------E-------#
#---------R--------------------O-----------------#
##--##-------##-#--####-------------#--------#---#
#----#-------###-####-##-------------------------#
#----#-------##----##--#####--------#--------#---#
#----#-------###-----------------------T---------#
#---S#-------##----------------------------------#
##################################################