#######------###############-----#########--------
#-----#------#------------##-----#-------#########
#-----#######----#-----#----######---------------#
#------------------------------------------------#
#----------------#-----#-----------------#########
#-----#######---------------######-------#--------
#-----#-----#----#-----#---#-----####--######-----
#######------#------------#---------#--#----#-----
--------------##--------##---#####--#--#----#-----
----------------########-----#----##----##--##----
----------------------------#----------------#----
------------##-##------------#---------------#----
-----------#--#--#-----------#######----###--#----
-----------#--#--#---------###------#--#--#--#----
-------#####--#--##########---#-----#--####--#----
-------#-----------------------#####----------#---
-------#---------------------------------------#--
-----###--###########-------------------------#---
-----#-----#---------#---------######--#--#####---
-----#-----#----------#---#####-----#--#--#-------
-----#-----#----------#--#----------#--#--#-------
-----#-----#----------#--#----------#--#--#-------
-----#######----------#--#-----------##-##--------
--------------------##----##----------------------
------------------##--------##--------------------
-----------------#------------#-------------------
----------------#--------------#------------------
---------------#----------------#-----------------
---------------#----------------#-----------------
---------------##################-----------------