###EE#############################################
#-----YYYY--Y----YYY---~~~~~~~~~~~YYY-------YYYYY#
#-----------------Y-----~~~~~~~~YY-----------YYYY#
#-------------O-------~~~~~~~~~Y------YY-------YY#
#-YY-YYYYYYYY-------~~~~~~~~~Y----------------YYY#
#YY-YYYYYYY-------~~~~~~----~--------------YYYYYY#
#---D--YYY-----Y~~~~~~##----------------YYYYYYYYY#
#-------------~~~~~~--##-------------------------#
#--~-~------~~~Y~~--------#######--###############
#~~~~~~~--~~~~~~~---------##---##--##------------#
#~~~~~~~--~~~~~Y-----YY-Y------------------------#
########--##---------YYYYY-----------------------#
#-----##AF##---------------##----##--------------#
#--------------Y#-#Y-------##----##--------------#
#--------------#---####################---########
#########--####-----##---------------------------#
#------#---------T----#--------------------------#
#-####-#-------------#-#--###########-----#------#
#------------###--###-----#-----O---------#------#
#------------##----##---------------------#------#
#----##-----####--#####-------------#-#---#------#
#----###---####----##--#####--#########---########
#------------------------------------------------#
#------------------------------O-----------------#
##--##-------##-#--####-------------#--------#---#
#----#-------###-####-##-------------------------#
#----#-------##----##--#####--------#--------#---#
#----#-------###-----------------------T---------#
#---S#-------##----------------------------------#
##################################################