#########-----------------------------------------
#-------####-------###########--------------------
#-----------##-----#---------#--------------------
#-------------##---#---------#--------------------
#-------##------##-#---------#--------------------
#########-##------##---------#--------------------
------------##---------------#--------------------
--------------##-------------#--------------------
----------------####---------#--------------------
------------------##---------#--------------------
-------------------###--######--------------------
---------------------#--#-------------------------
---------------------#--#-------------------------
---------------------#--#-------------------------
--------------------#----##-----------------------
------------------##-------##---------------------
-----------------#-----------#--------------------
-----------------#-----------#--------------------
----------------#-------------#-------------------
----------------#-------------#-------------------
---------------#---------------#------------------
---------------#---------------#------------------
---------------#---------------#------------------
----------------#-------------#-------------------
----------------#-------------#-------------------
-----------------#-----------#--------------------
-----------------#-----------#--------------------
------------------##-------##---------------------
--------------------##---##-----------------------
----------------------###-------------------------