###EE#############################################
#-----YYYY--Y----YYY---~~~~~~~~~~~YYY-------YYYYY#
#-----------------Y-----~~~~~~~~YY-----------YYYY#
#---------------------~~~~~~~~~Y------YY-------YY#
#-YY-YYYYYYYY---G---~~~~~~~~~Y----------------YYY#
#YY-YYYYYYY-------~~~~~~----~--------------YYYYYY#
#------YYY-----Y~~~~~~##----------------YYYYYYYYY#
#------G------~~~~~~--##-------------------------#
#--~-~------~~~Y~~--------#######--###############
#~~~~~~~--~~~~~~~---------##---##--##------------#
#~~~~~~~--~~~~~Y-----YY-Y------------------------#
########--##---------YYYYY-----------------------#
#-----##--##---------------##----##--------------#
#--------------Y#-#Y-------##----##--------------#
#--------------#---####################---########
#########--####-----##---------------------------#
#------#--------------#--------------------------#
#-####-#-------------#-#--###########-----#------#
#------------###--###-----#---------------#------#
#------------##----##---------------------#------#
#----##-----####--#####-------------#-#---#------#
#----###---####----##--#####--#########---########
#------------------------------------------------#
#------------------------------------------------#
##--##-------##-#--####-------------#--------#---#
#----#-------###-####-##-------------------------#
#----#-------##----##--#####--------#--------#---#
#----#-------###---------------------------------#
#----#-------##----------------------------------#
##################################################