#######------###############-----#########--------
#-----#------#---------T--##-----#-------#########
#-----#######----#-----#----######--F-------O----#
#-----------S--R-------------F---R------T-------S#
#-----------D----#-----#-----O-----------#########
#-----#######---O-----------######-------#--------
#-----#-----#----#-----#---#-----####--######-----
#######------#-------T----#---------#--#--O-#-----
--------------##--------##---#####--#--#----#-----
----------------########-----#----##----##--##----
----------------------------#--------T-------#----
------------##-##------------#---------------#----
-----------#A-#-O#-----------#######----###--#----
-----------#--#--#---------###------#--#--#--#----
-------#####--#--##########--F#-----#--####--#----
-------#---------P----T--------#####----------#---
-------#--T---R--------------D----------P------#--
-----###--###########------R------------------#---
-----#--OP-#---------#A--------######--#--#####---
-----#-----#----------#PPP#####-----#--#--#-------
-----#--S--#----------#--#----------#T-#--#-------
-----#-----#----------#--#----------#--#DF#-------
-----#######----------#O-#-----------##-##--------
--------------------##-DA-##----------------------
------------------##--------##--------------------
-----------------#------------#-------------------
----------------#---B-----B----#------------------
---------------#----------------#-----------------
---------------#----------------#-----------------
---------------##################-----------------