#######------###############-----#########--------
#-----#------#-------T----##-----#-------#########
#-----#######----#-----#----######---------------#
#------------------------------------------------#
#----------------#---O-#-----------------#########
#-----#######---------------######---T---#--------
#-----#-----#----#-----#---#-----####--######-----
#######------#-----T------#---------#--#--O-#-----
--------------##--------##---#####--#--#----#-----
----------------########-----#----##----##--##----
----------------------------#---------O------#----
------------##-##------------#---------------#----
-----------#--#--#-----------#######----###--#----
-----------#--#--#---------###------#--#--#--#----
-------#####--#--##########---#-----#--####-F#----
-------#----O------------------#####----------#---
-------#-----------------T---------------T-----#--
-----###--###########-------------------------#---
-----#--T--#---------#-------O-######--#--#####---
-----#-----#----------#---#####-----#--#--#-------
-----#-----#----------#--#----------#--#--#-------
-----#-----#----------#--#----------#-----#-------
-----#######----------#--#-----------#####--------
--------------------##----##----------------------
------------------##--------##--------------------
-----------------#------------#-------------------
----------------#--------------#------------------
---------------#----------------#-----------------
---------------#----------------#-----------------
---------------#########EE#######-----------------