##################################################
#-----YYYY--Y----YYY---~~~~~~~~~~~YYY-------YYYYY#
#-----------------Y-----~~~~~~~~YY-----------YYYY#
#------------D--------~~~~~~~~~Y------YY-------YY#
#-YY-YYYYYYYY---G---~~~~~~~~~Y----------------YYY#
#YY-YYYYYYY-------~~~~~~----~--------T-----YYYYYY#
#--T---YYYP----Y~~~~~~##----------------YYYYYYYYY#
#------G------~~~~~~--##-------------------------#
#--~-~------~~~Y~~------R-#######--###############
#~~~~~~~--~~~~~~~---------##---##S-##------------#
#~~~~~~~FS~~~~~Y-----YY-Y-----------------T------#
########--##---------YYYYY-----------------------#
#-----##--##---------------##----##----------O---#
#-O-----PO-----Y#-#Y-------##----##----D---------#
#--------------#---####################---########
#########--####-----##---------------------------#
#------#--------O-----#-----F------P-------------#
#-####-#-------------#-#--###########-----#------#
#------------###--###-----#------------T--#------#
#------------##-R--##---------------------#------#
#----##-----####--#####-------------#-#---#------#
#----###---####----##--#####--#########---########
#--O-------------------------------A-------------#
#------------------------F------------------R----#
##--##-------##-#--####--------PF---#--------#---#
#----#----T--###-####-##-------------------------#
#--T-#-------##----##--#####--------#--------#---#
#----#-------###---O-----------R-----------------#
#----#-------##----------------------------------#
#########################################EE#######