#########-----------------------------------------
#-------####-------###########--------------------
#-----------##-----#---------#--------------------
#-------------##---#---------#--------------------
#-------##---T--##-#---------#--------------------
#########-##------##----T----#--------------------
------------##---------------#--------------------
--------------##-------------#--------------------
----------------####------O--#--------------------
------------------##---------#--------------------
-------------------###--######--------------------
---------------------#--#-------------------------
---------------------#--#-------------------------
---------------------#--#-------------------------
--------------------#----##-----------------------
------------------##-------##---------------------
-----------------#-----------#--------------------
-----------------#-----------#--------------------
----------------#-------------#-------------------
----------------#-------------#-------------------
---------------#-----T---------#------------------
---------------#------------O--#------------------
---------------#---------------#------------------
----------------#-------------#-------------------
----------------#-------------#-------------------
-----------------#-----------#--------------------
-----------------#-----------#--------------------
------------------##-------##---------------------
--------------------##---##-----------------------
----------------------EE#-------------------------