##############___________########################################
#------------#___________#--------------------------------------#
#------------#___________#--------------------------------------#
#------------#___________#--------------------------------------#
#------------#___________#-----------------T--------------------#
#------------#___________#--------------------------------------#
#--------F---#___________#--------------------------------------#
#------------#___________#--------------------------------------#
#-------######___________############-----------R---------------#
#-------#___________________________#---------------------------#
#-------#___________________________#---------------------------#
#-------#############################-----O---------------------#
#---P-----------------------------------------------------------#
#---P-----------------------------------------------------------#
#---D-----------------------------------------------------------#
#---------------------------------------------------------------#
#---S-----------------------------------------------------------#
#---------------------------------------------B-----------------#
#---------------------------------------------------------------#
#---------------------------------------------------------------#
#---------------------------------------------------------------#
#################################################################