#########-----------------------------------------
#-------####-------###########--------------------
#---------S-##-----#-------T-#--------------------
#---------F---##---#---------#--------------------
#-------##--T---##-#-T-------#--------------------
#########-##------##---------#--------------------
------------##---O-------O---#--------------------
--------------##-----------R-#--------------------
----------------####---------#--------------------
------------------##---T-----#--------------------
-------------------###--######--------------------
---------------------#--#-------------------------
---------------------#PF#-------------------------
---------------------#AA#-------------------------
--------------------#----##-----------------------
------------------##-------##---------------------
-----------------#------T----#--------------------
-----------------#---------R-#--------------------
----------------#--T----------#-------------------
----------------#-------------#-------------------
---------------#------O--------#------------------
---------------#-----------T---#------------------
---------------#---------------#------------------
----------------#-R-----------#-------------------
----------------#-------------#-------------------
-----------------#----------O#--------------------
-----------------#-----------#--------------------
------------------##-------##---------------------
--------------------##---##-----------------------
----------------------EE#-------------------------