#######------###############-----#########--------
#-----#------#-------T----##-----#-------#########
#-----#######----#-----#----######---------------#
#-----S---------------------------D----R---------#
#-----D------T---#---O-#--R--------------#########
#-----#######---------------######---T---#--------
#-----#-----#----#-----#---#-----####--######-----
#######------#-----T--P---#---------#--#--O-#-----
--------------##--------##---#####--#--#----#-----
----------------########-----#R---##----##--##----
----------------------------#---------O------#----
------------##-##------------#---------------#----
-----------#A-#PP#-----------#######----###--#----
-----------#--#--#---------###------#--#--#--#----
-------#####--#--##########---#-----#--####-F#----
-------#----O------P-----------#####----------#---
-------#-----------------T-------R-------T-----#--
-----###--###########--R------------R---------#---
-----#--T--#---------#-------O-######--#--#####---
-----#-----#----------#---#####-----#--#--#-------
-----#-----#----------#--#----------#--#--#-------
-----#D----#----------#--#----------#-S#-F#-------
-----#######----------#SA#-----------##-##--------
--------------------##----##----------------------
------------------##--------##--------------------
-----------------#------R-----#-------------------
----------------#--------------#------------------
---------------#----------------#-----------------
---------------#----------------#-----------------
---------------#########EE#######-----------------